org.geometerplus.zlibrary.ui.android#80006:	  RUBBISH DOESN'T WORK AND GOES ALL DARK WHEN U WANT TO READ A BOOK 
org.geometerplus.zlibrary.ui.android#80014:	  It doesn't work properly last time 
org.geometerplus.zlibrary.ui.android#80019:	  After updating (since it's been a long time I did not update) I can't use my previous offline dictionary and was force to dl colordict. Wtf please, let me use my preferred offline dictionary. 
org.geometerplus.zlibrary.ui.android#80037:	  I have been using this app both free and paid for well over two year and it has been great. The best feature is the TTS plug-in that makes all your e-books audio books as well, great while driving and such. However after this last update I find that the app crashes to a blank screen and must be closed and reopened to use. I also find that the TTS plug-in now skips sentences and will repeat sentences with enough frequency to be very annoying. I hope this will be resolve in the next update. Beyond this bump in the road I still feel this app offers the best options for an ebook reader. 
org.geometerplus.zlibrary.ui.android#80042:	  Crashes when trying to view pdfs 
org.geometerplus.zlibrary.ui.android#80044:	  My fiance tried to get me to use this with my first Android phone, but I was too lazy. I finally put it on my first tablet, and was in love. It was le cre de le cre for several years. Unfortunately, that's no longer true. It can't find some folders - hence missing the books in them - which ruins the whole bloody point! It also tends to crash incessantly while reading PDFs, even with the needed add-on. Thoroughly annoying. I still recommend it for first-time users, but I'm looking for something new myself. 
org.geometerplus.zlibrary.ui.android#80045:	  Can't open settings... The app crashes every time I want to use settings. So i can't set up a Cyrillic font and therefore the app is worthless. 
org.geometerplus.zlibrary.ui.android#80052:	  It suddenly start to crash 
org.geometerplus.zlibrary.ui.android#80060:	   You must have many free books as you can. I can't find some of the free books here 
org.geometerplus.zlibrary.ui.android#80081:	  Best app on my phone.. Including phone itself. After trying 7-10 other e-book readers and finding multiple issues with each one, I stumbled across this one (thinking it looked so basic it was gonna be another crappy one) with nothing to lose...6 years and 7 phones later it remains my all time favorite, and most used app ever. I use it by far more often than any other app, including the phone dialer. Every new phone I've gotten this has always been the first app to go on, and flawless syncing with FB reader and Google drive means I just have to download and sign in on new phone and everything is right in the world again.. plus I can pick up any of my multiple devices and open to same spot no matter what device I stopped on.. Can't go on enough about how much i love this reader.. bought the premium version not because the free one was lacking.. Honestly if I never even open the premium version and kept using the free one it will be worth the price after the years of enjoyment from free one.. Really just buying it to thank developers. Couple of small changes might make it PERFECT (really I'm nit picking here) 1. Auto scroll would be awesome for people like me who need larger font so we don't need to turn page every 3 servings 2. Pinch to adjust font size (for same reason) 3. Bookmarking could be made easier with dedicated space in corner... And that's all I can think of that isn't perfect 
org.geometerplus.zlibrary.ui.android#80082:	  Works well, easy to use and doesn't use up a lot of storage space. 
org.geometerplus.zlibrary.ui.android#80084:	  Works well, with convenient access to free ebook libraries. Requires almost no permissions. Dev fixed a bug I had (or caused) very quickly. Thanks! 
org.geometerplus.zlibrary.ui.android#80096:	  Very good reader, but with 1 minor issues. When browsing folder tree,It does not support Google drive. As A result I have to download the file to my device first for certain format. 
org.geometerplus.zlibrary.ui.android#80101:	  Probably the best such app on the store and, here I speak with complete certainty, my favorite app. Though, there is one problem. I can't access books on my SD card. I don't know why. I just changed my card and moved all the books from my old card to the new one. I know the books are there because when i move them from the card to the phone I can access them, but when I put them back in the card I just can't access them. Otherwise it's a great app! 
org.geometerplus.zlibrary.ui.android#80106:	   I used to read on the Kindle app, but sometimes got annoyed due to it not reading some formats. I found this one about 3 years ago and haven't had a single issue. I LOVE it. 
org.geometerplus.zlibrary.ui.android#80115:	   Readout aloud using google text to speech does not work properly and we shouldnt need plugins anymore,please deliver a premium experience as the name suggests. 
org.geometerplus.zlibrary.ui.android#80124:	   Hated that I couldn't open another app and listen to my book at the same time. This is something the creators should have considered when making this. 
org.geometerplus.zlibrary.ui.android#80131:	  Wonderful app. Works well and has all the options I need with the plugins. And I like I can pick and choose which ones I need at the time (I don't have a lot of internal storage on my phone but my tablet has them all installed). I would buy the Premium version but it won't work with my phone and Google won't let me purchase it (I would do it just to support the developer). Either way, please continue support of older devices (2.3) in this version. Thank you! 
org.geometerplus.zlibrary.ui.android#80140:	   I can't access the storage on my phone, only the sd card. My books are downloaded right onto the phone and I can't access any of them. Is there a way to grant the permission to access them? 
org.geometerplus.zlibrary.ui.android#80143:	   I used it for a couple of months but had constant problems with finding an off-line dictionary that would work with it smoothly. 
org.geometerplus.zlibrary.ui.android#80154:	  cannot save books to external sd card. 
org.geometerplus.zlibrary.ui.android#80164:	   Some epub files read with to many spases between sentences. When I open same file in another app , there is not such as problem. 
org.geometerplus.zlibrary.ui.android#80177:	  Well... it just does not work that way... bad UI... weird setting.. just nope 
org.geometerplus.zlibrary.ui.android#80178:	   Nice free reader. I like being able to search books using a word term. Suggestions: More menu options like, Do NOT open the last book read when using the app next time because it takes years to load it and I want to read something else. Or easier way to always get to settings or your library of books in one click. 
org.geometerplus.zlibrary.ui.android#80182:	   Worst Ever Interface. Crashes agian and again 
org.geometerplus.zlibrary.ui.android#80184:	   This app absolutely butchers the page format of some books, no matter how much I adjust the settings. I found other free readers though, that can open those very same files without any problems. Sorry FBReader, but you need to seriously up your game. 
org.geometerplus.zlibrary.ui.android#80193:	   What happened to the reading mode? Can't find it anymore. That was the only reason I liked the app. 
org.geometerplus.zlibrary.ui.android#80225:	   Very good reader. But I have a performance issue with it: after reading several days 800 pages mobi file (20 minutes a day) the app becomes sluggish - interface is slow and pages are scrolled with noticeable delay. Workaround is to remove the app in task manager and start again. My phone is Oneplus 3 (6GB of ram) 
org.geometerplus.zlibrary.ui.android#80229:	   The files that I read doesn't save it's reading location any more with the latest update keep resetting to the beginning older versions was better...a bit buggy laggy studder last few update added optimization issue becoming crappy like it's paid brother getting worse 
org.geometerplus.zlibrary.ui.android#80236:	  Bullshit, can't open pdf-file 
org.geometerplus.zlibrary.ui.android#80238:	   best ebook reader. out there. v 2.7.8 fixed all my issues even though they were minor. GREAT JOB. 
org.geometerplus.zlibrary.ui.android#80259:	   But after using it much iam still failed to found out the options for highlights lines... 
org.geometerplus.zlibrary.ui.android#80264:	   Highly customizable without being cluttered. I am very picky regarding the visual quality of the text. This app satisfies all my desires ;) (EDIT) crashes when opening epub files around 24MB with images. 
org.geometerplus.zlibrary.ui.android#80272:	   Actually the app doesn't work. Always demand to install FBReader when launching (the reader has been already installed). My phone is Meizu MX4. 
org.geometerplus.zlibrary.ui.android#80277:	   I am so very happy with this reader, and won't ever use another! *Sidenote* In the latest update I've found a bug - the screen dims after a while, even if switched to 'always on'. . . Otherwise, perfect!  
org.geometerplus.zlibrary.ui.android#80291:	   It's just plain nice and good never had any problems with it. 
org.geometerplus.zlibrary.ui.android#80298:	  Used to be OK, had the occasional problem when the library emptied itself now have the additional problem of having a blank screen when I open the app. 
org.geometerplus.zlibrary.ui.android#80323:	   I don't know if this is the place to report issues, but as of the latest version the "align" tag does not appear to be recognized. Every other EPUB reader I've used can recognize and render them. 
org.geometerplus.zlibrary.ui.android#80324:	   It didn't work i hate this app 
org.geometerplus.zlibrary.ui.android#80333:	   I'm on RU1.1.124 and switching to the second screen doesn't work. Tried to use YotaMirror, but then the screen never does a full page refresh and leaves traces of previous pages. 
org.geometerplus.zlibrary.ui.android#80335:	  I still cannot download a full complete chapters of a book just a sample 
org.geometerplus.zlibrary.ui.android#80339:	   Book rendering is superb, UI simple and efficient. There is however an annoying bug that prevents me from giving more stars! It constantly uses CPU, even after I switch away from it, and I see two FBReader threads/processes constantly hogging my two cores. I finish reading sessions by switching to FBR's app properties and Force Closing it, else my battery would last considerably shorter! Of course that also means FBR reading sessions can't last too long without recharging.... 
org.geometerplus.zlibrary.ui.android#80347:	   I love this app very much...but suddenly i m having problem..now i can't see table of contents option in menu before i can see that but not now.please fix this 
org.geometerplus.zlibrary.ui.android#80348:	  Now that the position save bug has been corrected, this is again the best ebook reader that I know 
org.geometerplus.zlibrary.ui.android#80362:	   I've been using FBReader for almost 2 years now and it never once let me down. But there is a recent hiccup on my new phone. The page turn (curl) animation is laggy and not smooth at all. My phone is a decent one and it plays high end games like a charm so performance shouldn't be an issue. Please fix this for me or if possible let me know of any possible fix for this. Cheers. 
org.geometerplus.zlibrary.ui.android#80365:	   I was reading an epub, it crashed every time I wanted change the page from page bar. finally I removed it. for reading PDF you should add an extra plug in. it's a huge heavy app. but nice and useful UI. 
org.geometerplus.zlibrary.ui.android#80367:	  Not user-friendly 
org.geometerplus.zlibrary.ui.android#80378:	  Excelent application. But has problems with double tap on Android 5.1.1. Sometimes to single taps as double taps. 
org.geometerplus.zlibrary.ui.android#80380:	  The app is great for mobi or epub formats,but for cbz,cbr or pdf you need to zoom and then the scrolling feels awkward,also it doesn't load the book properly,which is a shame in an otherwise brilliant app 
org.geometerplus.zlibrary.ui.android#80390:	   It couldn't locate any books when I told it to scan - it didn't even react and try to scan as far as I'm aware, and the app overall didn't seem to work well. It was cumbersome and useless, since it couldn't load any of my books. Even the premium version (&gt;$4, wth) failed to work. Not remotely worth a damn. I installed UB Reader which much greater success. 
org.geometerplus.zlibrary.ui.android#80401:	   At last I can access my SD card. My other readers lost that on latest android version. But it will not open lit files. Is this a bug or not supported? 
org.geometerplus.zlibrary.ui.android#80405:	   I love this app, but it is no longer allowing me to download public domain books through it. Why is that? Please fix!! 
org.geometerplus.zlibrary.ui.android#80414:	   I cannot find out how to show original page numbers (many epub books have these numbers now). 
org.geometerplus.zlibrary.ui.android#80416:	   If the makers are reading this plz tell me how I can download the full book and the sample does not download until I keep trying 
org.geometerplus.zlibrary.ui.android#80427:	  I don't know whose fault it is (Samsung or the apps), but I am so tired of not being able to find my folder! I want to select the folder to save books in, which is the folder all the books I have are already in, and this folder is on my SD drive. I can't get to it with the directory in this app. It doesn't seem to be able to find my SD. It's a problem with almost all apps, but since there are a few that do it right, it's obviously possible to do it right. 
org.geometerplus.zlibrary.ui.android#80432:	  Some thing's gone wrong with this (previously) excellent reader. Can't create customized shelves any more. Can't save to favorites either. 
org.geometerplus.zlibrary.ui.android#80439:	   I was going to use yours, but you don't synchronize from Google Play Books. They are always stupid and erasing my hard work. Ugghhhhh. Doesn't anyone care and work right?! 
org.geometerplus.zlibrary.ui.android#80440:	   I have been using this e-reader since I got first android phone back in early 2010 and it is by far the best e-reader app I have come across, wouldn't use any other app. .... 4 years later and still using it 
org.geometerplus.zlibrary.ui.android#80450:	   Have used this on 3 phones and 2 tablets and never had a problem with it. Great app!! 
org.geometerplus.zlibrary.ui.android#80458:	    could not get it to work so  could read a book it took me 2 minutes to find out how to work it other than that it was great 
org.geometerplus.zlibrary.ui.android#80459:	   Dictionary options are limited. Can't use other dict. Tools. Directory scan rarely works even though pointing scanner at Target folder. 
org.geometerplus.zlibrary.ui.android#80466:	   Won't open any files even pdf's freely? I'm not paying for anything until u show me smthg! 
org.geometerplus.zlibrary.ui.android#80476:	  Sometimes after closing the app, The book will disappear and I have to search for the book and the page where I read last time to continue my reading. I hope that you guys could did fix this bug. 
org.geometerplus.zlibrary.ui.android#80481:	   I had exported an Epub file directly from my drop box to my android, but as I opened the file with Google play books the file did not open as "fit" for reading. Rather, I had to zoom in on every page in order to read. I attempted to customize the settings, but no option existed to format the reading content. Hence, I began searching for epub apps that would enable me to read the book just like I would on a regular kindle fire... I did attempted to open it using kindle but kindle only accepts a few formats.. 
org.geometerplus.zlibrary.ui.android#80486:	  Did not work 
org.geometerplus.zlibrary.ui.android#80503:	   I couldn't understand how open my books, I couldn't find book's search on my phone, stupid app, I hate it 
org.geometerplus.zlibrary.ui.android#80506:	   Has been my go-to reader for years now. Offers all I need. Just bought premium, not because there were ads, but exactly because I felt I owed them for having created a great reader for free that was ad free. 
org.geometerplus.zlibrary.ui.android#80553:	   After upgrading to Android 6.0.1, fb reader app stop opening my epub books collection. Please solve this problem. 
org.geometerplus.zlibrary.ui.android#80559:	  Like many other's doesn't work, because of the screen overlay on SG S7 Edge 
org.geometerplus.zlibrary.ui.android#80561:	  Won't access SD card on galaxy s5 
org.geometerplus.zlibrary.ui.android#80566:	  Its crashing now 
org.geometerplus.zlibrary.ui.android#80570:	   i tried to read a comic in .epub format....... the pages were too small to read........ zoom in button was not working........ wasted my time..... 
org.geometerplus.zlibrary.ui.android#80583:	   This app is easy to use, easily customizable, and hasn't given me any problems so far. 
org.geometerplus.zlibrary.ui.android#80585:	   When press on the word and select it will show menu. But it menu pop-up some time bottom of screen, some time top of screen. It is very hard for using menu. Please, fix it on the bottom. 
org.geometerplus.zlibrary.ui.android#80588:	   Can't download any books!! :( 
org.geometerplus.zlibrary.ui.android#80590:	  I couldn't get over the fact that I can't change the font out of the theme setting it is in 
org.geometerplus.zlibrary.ui.android#80600:	   Do not download this app it is not what they make it out to be! 
org.geometerplus.zlibrary.ui.android#80606:	   I cannot find one of my books which is called 'anastasia has the answers' and for my second book ' Millicent Min : Girl Genius's I can only read sample 
org.geometerplus.zlibrary.ui.android#80613:	   Loved it, did everything I wanted, print was so clear THEN I got a Samsung update for my tablet and now it doesn't load books on - No application found. Does anyone have an answer to this, please? 
org.geometerplus.zlibrary.ui.android#80614:	   Slow clumsy and sluggish app. Optimize code. Buggy crashes often and no way to increase font size. 
org.geometerplus.zlibrary.ui.android#80617:	   Would not find epub books in folder added to books search path. 
org.geometerplus.zlibrary.ui.android#80629:	   I like this reader. The biggest problem is it won't let you close an open book. I opened a book to get a quote, now every time I open it that book defaults, even though I am in the middle of another book. It is very annoying. 
org.geometerplus.zlibrary.ui.android#80643:	   I installed this because of its purported compatibility with so many different types of files, but it wouldn't open half of my ebooks. I had a few that aldiko wouldn't read, but with this app, I still couldn't read them and couldn't read quite a few that aldiko handled fine. Wasted money on the premium to get the bookshelf. Not worth it. Going back to aldiko. 
org.geometerplus.zlibrary.ui.android#80649:	  Been using this for years. Won't use anything else. Works great. 
org.geometerplus.zlibrary.ui.android#80653:	   Did not open  PDF book. 
org.geometerplus.zlibrary.ui.android#80654:	  Okay but you can't find famous books here 
org.geometerplus.zlibrary.ui.android#80658:	   It's unclear how to activate the text-to-speech plugin (I often like to listen to books on headphones while running tasks). I got it to work ONCE and when I did, I wanted to change the voice. No matter how many times I selected the voice I wanted, it returned back to the annoying default voice every time. Other than those 2 problems, I think this app is on-point. Ad free and has an easy night-time setting which is very useful. Great job 
org.geometerplus.zlibrary.ui.android#80660:	   Liked it when i first downloaded it. Now suddenly i can not find my books anymore and if i go via files it wont open azw3 books 
org.geometerplus.zlibrary.ui.android#80672:	   Shifted from moon+ reader to try it out and it did work well for small files, but once I tried to read 10mb+ epubs, it started to crash. Uninstalled, went back to moon+ reader... 
org.geometerplus.zlibrary.ui.android#80680:	   I wish it would store books on The SD card instead of the main storage drive. Please fix. 
org.geometerplus.zlibrary.ui.android#80698:	   Tts plugin was installed, but 'speak' option is missing from menu where in a previous version it was present. Please address this problem devs. Last update in April. Have they all gone on holiday? Hard to believe they could abandon this cherished app. It has been effortlessly the very best of its kind when working as intended 
org.geometerplus.zlibrary.ui.android#80704:	  Cannot open anything from local folders because permission is denied. Android 6. 
org.geometerplus.zlibrary.ui.android#80705:	   U say it has all book it dosent don't get it ! 
org.geometerplus.zlibrary.ui.android#80707:	  PDF reader, which can't open simple pdf file without asking to buy premium or download some other trash. 
org.geometerplus.zlibrary.ui.android#80721:	   Can't open epub files from my onedrive with the app. Wouldn't display the files on windows version either. 
org.geometerplus.zlibrary.ui.android#80733:	   If I zoom in to fit the text and then I want to scroll down to the next pages it doesn't work. I have to either zoom out and change or use the silly volume buttons to change the page and even then it does in a horrible clumsy way not fluid at all. I would remove the comment if I get my money back. 
org.geometerplus.zlibrary.ui.android#80737:	   It was ok initially but the Brightness is at its maximum right now it doesn't come down even if I keep the phone brightness to minimum possible .. Could you please fix this problem.. I've paid for this application and now I can't use it. 
org.geometerplus.zlibrary.ui.android#80744:	   I downloaded an .epub file and for some reason Google books, the Kindle app, and Adobe PDF viewer all couldn't open it, but this app opened it on the first try. Thanks! 
org.geometerplus.zlibrary.ui.android#80745:	   Not easy to organize your books. Tags, collections, etc., can't be created unless you are editing a book. They don't have a scrolling menu so you have to remember and type them. Can't select "Mark as Read" for a book, only as "unread", and books I have read tell me it's 85% done (can't do anything about it). Can't edit Info's for more than one book at once so when you upload a lot of books, like I did, you have to go one by one, or give up. Can't upload a whole directory file, only sub-files one by one. Not the easiest or nicest app to use either. Need to add other add-ons to have pdf, bookshelf views, etc. The app is draining a lot of energy. But the paper effect background is nice, so it's a point in their favor... 
org.geometerplus.zlibrary.ui.android#80748:	   I was a super fan of this app for 2 yrs but it didn't open a book. There must not be an app that don't work for all... hate it 
org.geometerplus.zlibrary.ui.android#80750:	  Fb reader is my favorite but its start work awful recent times, reading book don't work and library shut down 
org.geometerplus.zlibrary.ui.android#80754:	   With mobis and epubs it works snappily, library, bookmarking and footnotes are properly handled and night mode is an eye savior. Only issue with those formats is inability to zoom into the tiny diagrams and images. Reading pdfs though is a complete horrorshow with no auto sizing of the original tiny font so you're forced to zoom and drag. Worse, one must zoom out to run the page and then zoom in again with the new page. The thing that bothers me most though is why this app name? 
org.geometerplus.zlibrary.ui.android#80768:	  Buy premium or " whooops" it doesn't work 
org.geometerplus.zlibrary.ui.android#80771:	   One of the first apps I install on every phone and tablet, I don't use the book shelf as I prefer to manage books by folder and open from es file explorer or Dropbox. Love ability to quickly change brightness and page with a swipe, and that I don't have to keep turning device back on if I don't read a page I'm time (as long as 50%+ charge). TL:DR For me it just works the way I want out of box. 
org.geometerplus.zlibrary.ui.android#80777:	   bad bad bad error crash...... in the past now superb. good job 
org.geometerplus.zlibrary.ui.android#80780:	   Reduced 1 star because the Bookshelf View (of which the UI could be enhanced) and TTS function is not available with the app. One has to install separate plugins for them. Same in the case of PDF Reader you have to install plugin. Hence, leading to the increase in the size of the app on the whole. However, it could be the best reader out there in PlayStore ........ Just by fixing these shortcomings. :) 
org.geometerplus.zlibrary.ui.android#80788:	  Didn't scan and didn't open any files. 
org.geometerplus.zlibrary.ui.android#80801:	  After the latest update crashes every time I try to delete book 
org.geometerplus.zlibrary.ui.android#80802:	   This app WAS working okay, but the brightness adjuster on the left side of the screen does not work very well, and just recently the page turning has stopped working completely. Uninstalled. 
org.geometerplus.zlibrary.ui.android#80809:	   Tutorial screen does not go off. Fix your app and give others freedom to learn things by themselves rather than forcing them to go with your tutorial. 
org.geometerplus.zlibrary.ui.android#80811:	   Finds file in search, sees the files inside but says can not open when I click read 
org.geometerplus.zlibrary.ui.android#80828:	  Doesn't save on SD card 
org.geometerplus.zlibrary.ui.android#80833:	   've searched for .prc in Google Play, and this app was the first result. How it is possible, that it will not open .prc files? What plugin do I need to install? Is it supposed at all? 
org.geometerplus.zlibrary.ui.android#80836:	   The app shows a lot of question marks within the lines in regular English mobi and epub books, which previous versions were showing properly rendered. What's the problem? 
org.geometerplus.zlibrary.ui.android#80854:	   Simple UI? Best e-reader? Wth! The first time i opened the app, i was confused how to find my e-books. And accesing sd card crashed this f##king app (i tried it 3 times). The reason i installed this app was because it was only 5+ mb when others took 20+mb or so. Now its a bye bye. 
org.geometerplus.zlibrary.ui.android#80868:	   Cannot open any mobi or epub file on the device. No other reader, and I tried many, had problems with them. Uninstalled the app until you fix this. 
org.geometerplus.zlibrary.ui.android#80879:	   This is one if the saddest readers on the market. It's page turning animation will make you want to throw your device. It's line spacing is terrible. Background is poor.sometimes won't open files converted by Calibre. Too many functions, which is nice, but the results produced by then are terrible. And to top it all, all the great features are a part of in-app purchase. 
org.geometerplus.zlibrary.ui.android#80901:	  Keep creating problems. not finding it cool and set my phone hangng for many time and not taking any book from library. so not installing untill it gets better 
org.geometerplus.zlibrary.ui.android#80907:	  Crash whenever I press back button 
org.geometerplus.zlibrary.ui.android#80908:	  Change how the Reset Page popup is displayed it opens too easily. Why not just add it as a menu item? Can't see why anyone would be resetting and changing the page on a regular basis. Really annoying and not a real useful function anyway. ------ Stop the app from jumping forward 5, 10 pages when you put the phone in your pocket. ------ Fix the navigation; click on "By Author" and select an author and it just displays the recently read books by that author. If on the other hand you open by "File Tree" it finds all the books by that author. 
org.geometerplus.zlibrary.ui.android#80910:	   As the title suggests, this is really the best ebook reader in the Play Store. It is the only one I have ever kept on all four (yes, 4!) of my current Android devices. The one time I ever encountered a small issue, I emailed the developer, and got a personal reply the same day, and a working fix was issued the very next day. On a weekend! I could not possibly ask for more. The app works perfectly, and all is right in my ebook world. 
org.geometerplus.zlibrary.ui.android#80921:	   never upgrade to pro version - waisting of money. Can't open epub file, however fbreader premium working fine. COOL FEATURE ADDED! 
org.geometerplus.zlibrary.ui.android#80929:	  After some minor bug fix, this app is my favorite 
org.geometerplus.zlibrary.ui.android#80961:	   Not working after update. Pls fix. 
org.geometerplus.zlibrary.ui.android#80972:	   Its a fine app but when it comes to adjusting brightness the app most of the times doesn't even recognize that I touched the left side and am rubbing my finger up and down. There might be other such bugs. I just found one so please look into it. 
org.geometerplus.zlibrary.ui.android#80981:	   Hi, i just downloaded this and every few minutes while i am reading, the app would bring me back to a previous page and i would have to scroll again to find what page i am at. This is very irritating and it ruins my reading pace. If you can fix this problem then i would rate it 5 stars 
org.geometerplus.zlibrary.ui.android#81001:	   Couldn't load the one ePub I have. Tutorial eBook wouldn't close out, was always opening when I started the app. Uninstalling. 
org.geometerplus.zlibrary.ui.android#81004:	   It doesn't load personal library. 
org.geometerplus.zlibrary.ui.android#81009:	  Never crashes. I've had it for months. Love it because the epub format is my fave. Only problem i got with it is it doesn't support pdf, which is a more popular format with book downloads. 
org.geometerplus.zlibrary.ui.android#81015:	   I've used the app for a year or so now and love it. The Brightness adjustment stopped working in the last update. Needs to be fixed for night reading. 
org.geometerplus.zlibrary.ui.android#81024:	   I haven't used many of its features, but text is excellent. 
org.geometerplus.zlibrary.ui.android#81030:	   I've tried a number of these readers and this is the only one that I'm comfortable with. It reads most formats flawlessly, allows you adjust the brightness with a flick of the finger WITHOUT having to dive through a bunch of menus, and it hasnt crashed once in the past few months that I've been using it. Keep up the good work fellas! 
org.geometerplus.zlibrary.ui.android#81033:	   Not user friendly 
org.geometerplus.zlibrary.ui.android#81037:	   This is the best reader app by far , only problem i have is with arabic language epub books , the words themselves are showing fine but they are in the reverse order in the lines , they are shown from left to right while in the arabic language it is from right to left . please fix it . 
org.geometerplus.zlibrary.ui.android#81054:	   Not intuitive, could not find how to open files, wanted to read djvu files, although downloaded a special plug-in for it. 
org.geometerplus.zlibrary.ui.android#81063:	   Excellent reader! However, after some of latest updates time to time looses last reading position on my Samsung S5, so one star off. Update on March 1, 2016: No more problems with the position! Thanks a lot! 5 stars! 
org.geometerplus.zlibrary.ui.android#81075:	   Good reader but after the latest 2.6.9 update still doesn't allow to download any book to the SD card. Error in the folder creating. It's more than 15gb on SD card... 
org.geometerplus.zlibrary.ui.android#81080:	   The screen goes off with the new update. This has not happened before. Please fix this at the earliest 
org.geometerplus.zlibrary.ui.android#81084:	   Some .epub format books are not loading. If loads not responding 
org.geometerplus.zlibrary.ui.android#81086:	   When ever anything breaks, it is fixed soon. Thank you. 
org.geometerplus.zlibrary.ui.android#81095:	   Since the last update, my save position has been messing up. The book is not leaving off where I left it. Every time I open it up I have to search forward several pages to find the right spot wasting time. ..... please fix. Galaxy Note 5. 
org.geometerplus.zlibrary.ui.android#81107:	  I can't find my bookmarks for each book after the update. The bookmarks tab disappeared after the update. 
org.geometerplus.zlibrary.ui.android#81120:	   Some "update". It now won't open any new books from my Google Drive app. 
org.geometerplus.zlibrary.ui.android#81121:	   Doesn't open lit files 
org.geometerplus.zlibrary.ui.android#81132:	  don't download 
org.geometerplus.zlibrary.ui.android#81135:	  Used to be my favourite reader but now for some reason I cannot open new files with it. I disabled the google books app. But boe it says that the files (epub) cannot be opened. Any ideas? :'( 
org.geometerplus.zlibrary.ui.android#81141:	   It does not work properly in galaxy note 8. Please try to fix it 
org.geometerplus.zlibrary.ui.android#81156:	  Thanks so much for the quick response. Problem sorted and it's worthy of 5 stars again. 
org.geometerplus.zlibrary.ui.android#81167:	   what kind of "Best ebook Reader" that can't open secure (password protected) files? do we need to install other app for this? 
org.geometerplus.zlibrary.ui.android#81168:	  I couldn't get to a book to choose and its written in a weird incomprehensable way!! 
org.geometerplus.zlibrary.ui.android#81179:	   Crash every time I try to open 
org.geometerplus.zlibrary.ui.android#81181:	  I was primarily interested because this is one of the few which can read AZW3 (mobipocket) format (besides kindle) but realised rendering of same is not very good, ToC was missing and and the files was depicted rather like a .rtf file. Other file format are satisfactory. But biggest problem is that notes and book marks can not be exported or imported making this unsuitable for dedicated eBook reading application. 
org.geometerplus.zlibrary.ui.android#81182:	   Haven't used any other .epub reader so can't do a comparison but I haven't had any problems with it. I mostly use it on .epub and occasionally .txt 
org.geometerplus.zlibrary.ui.android#81184:	   Overall best app for reading & accessing my Calibre libraries. My issues with slow responses to turning pages & opening he settings menu seem to be external and not the apps fault. 
org.geometerplus.zlibrary.ui.android#81199:	  Same storage permissions problems that other people are having on marshmallow. If it's not the app's fault it needs to let me know what to do to fix it. 
org.geometerplus.zlibrary.ui.android#81211:	   Appreciate that the free app still gets updates and issues fixed, thank you. So far the app is real good  
org.geometerplus.zlibrary.ui.android#81213:	   Option "Show status bar" doesn't work properly in full screen mode. :( 
org.geometerplus.zlibrary.ui.android#81215:	   What is going on here! After the latest update it does not open books just shows the welcome to fb reader document 
org.geometerplus.zlibrary.ui.android#81219:	   I've been using fbreader for many years, on the Nokia N770 and Sharp Zaurus, maybe even on Windows CE. I'm sad to say that my time with fbreader may be at an end, at least until Marshmallow support is added. For both the internal memory and SD card, I get a permission denied error when attempting to access directories on them. Consequently, I can't open any books but the built-in help book. Looks like I'm off to find an alternative, hope that fbreader adds Marshmallow support soon! 
org.geometerplus.zlibrary.ui.android#81220:	   What happened to the bookmarking icon? Having to go through the menus does not cut it.....Please fix and the stars come back! 
org.geometerplus.zlibrary.ui.android#81228:	   I didn't use yet but the reviews gives the best profile of this app 
org.geometerplus.zlibrary.ui.android#81234:	   The only thing I don't like, and this might just be me, is the way the the highlighter works; I used to like the colors before but now they are dull and pale. If I choose yellow, it is a faded yellow. That's the only problem. Other than that it is great! 
org.geometerplus.zlibrary.ui.android#81244:	  Read 30+ epub books over the last year and a half, never a single issue ever. Able to configure everything the way i want. Amazing app! 
org.geometerplus.zlibrary.ui.android#81246:	   Search feature stopped working. 
org.geometerplus.zlibrary.ui.android#81265:	   I like all the changes which I also suggested, like modern look and page numbers in TOC. The new intuitive and organized menu with book cover and more background customization is wonderful. The page algorithm is fixed too now. Excellent  
org.geometerplus.zlibrary.ui.android#81269:	   Always crash. 
org.geometerplus.zlibrary.ui.android#81272:	   The page doesn't turn when I press the left or centre of the page.It only turns when the eight hand screen is touched.Its bane for a left handed person.Plus the in my android 5.0.2;I can't see the default home or back option.It is only visible when I drag it from up.There's also an issue of the reset position i.e.the page no. to pop up when I press d centre of the screen. Please if u could change the interface so that wherever I touch would change the page; would be grt. 
org.geometerplus.zlibrary.ui.android#81285:	   I have purchased the premium version, there is one option missing and its highly annoying, and that is not being able to add multiple books to shelf simultaneously. Its really frustrating to add books one by one. Kindly fix this issue 
org.geometerplus.zlibrary.ui.android#81306:	  Stopped working on my device Explay Fresh. Before the recent update everything was fine. 
org.geometerplus.zlibrary.ui.android#81313:	   So many options. If you can't make your book layout appear how you like, just go into Settings and fix things. Reads every format. 
org.geometerplus.zlibrary.ui.android#81316:	   This reader is seriously the best I've ever had, but lately it crashes all the time. I clear the cache history etc, but it still crashes. Some help? 
org.geometerplus.zlibrary.ui.android#81320:	   Crashing over and over on Android 4.4 PLEASE FIX THIS,and I will RATE IT 5 STARS 
org.geometerplus.zlibrary.ui.android#81326:	   nice app but have some problem 
org.geometerplus.zlibrary.ui.android#81328:	   Since the last ui update, there are glitches when going to the next page. Something like loading 95% of next page, then freeze for 1 sec, then 100% load. I have a good phone (2gb ram, cpu 4x 1.5GHz), so it's not about me. Hope you'll fix it someday. It's not a big problem. 
org.geometerplus.zlibrary.ui.android#81332:	   Latest update has made FBR crash and freeze my whole phone to lock up. 
org.geometerplus.zlibrary.ui.android#81335:	   No open file feature or any useful feature. 
org.geometerplus.zlibrary.ui.android#81340:	   I like the reading and customization functions of this reader a great deal. However, there are some inexcusable failures. First of all, it fails to follow Internet links! This is a deal-breaker, period. Then there's the network sync. Neat idea, but my tablet is constantly connecting get to the FBR website, even when sync is disabled. Unacceptable!!! Finally, the library sucks - including the plugin library. 
org.geometerplus.zlibrary.ui.android#81343:	   This is a truly great, highly customizable reader. Only question I have is why the night/day button disappears and reappears from landscape mode at certain times of the day? Revised: Thanks for fixing the glitch with the night/day button. Now it's visible all the time, regardless of screen orientation and time of day. 
org.geometerplus.zlibrary.ui.android#81345:	   Even after reinstall, I can't use it  
org.geometerplus.zlibrary.ui.android#81348:	   I really like the app but when I updated it into the latest version, I can't open the app anymore. It keeps saying "Unfortunately fbreader has stopped". Now I can't read my books.Please kindly look into this issue. 
org.geometerplus.zlibrary.ui.android#81357:	  It crashed after last update 2 days ago. I was just going to give it 5 stars. Why not left it as it was. All the downloads before this update are totally unreadable. It took quite an effort to organize them, it is a pity. I tried to reload it but it still reads an error with some texts, it used to be perfect but the last update has degraded it considerably. I am going to look for a better reader. 
org.geometerplus.zlibrary.ui.android#81360:	   This use to be my favorite reader, was installed on all of my devices! Since the update, I've either lost all of my books, or can no longer open them (no matter how many plugins), please fix the "fix" 
org.geometerplus.zlibrary.ui.android#81366:	  Crashed right after installing 
org.geometerplus.zlibrary.ui.android#81372:	   I noticed today that since it's been updated, I have no idea how to remove the bookmark I put on. I've tried pressing the highlighted word then pressing the cross. That does nothing. Nothing I do gets rid of it. Please help. - Ah, I have just found a way of doing it. By touching a place where there's no typing and pressing the 3 lines in the corner, then going to "bookmarks". - NOT EASY when you have a disability and can't use your hands properly. 
org.geometerplus.zlibrary.ui.android#81374:	   i don't use an e-reader much, but this is the only one i install and use. Great app. keep it up. i love the 'free-ness' of it. 
org.geometerplus.zlibrary.ui.android#81383:	  Creating problem :( 
org.geometerplus.zlibrary.ui.android#81394:	   Can't download it.. Thought it was the phone's fault but turns out its not the phone. Because I tried downloading it twice. 
org.geometerplus.zlibrary.ui.android#81400:	   But back to close app doesn't work on my galaxy tab s2 
org.geometerplus.zlibrary.ui.android#81408:	  Crashes almost all the time when I want to open an epub file. Useless crap. 
org.geometerplus.zlibrary.ui.android#81414:	   I honestly love this app so much but I having a problem now. The app is not reading any new epub files that I download. PLEASE FIX THIS PROBLEM 
org.geometerplus.zlibrary.ui.android#81424:	   it doesn't open dictionary on long press while i selected the option to open dictionary on long press 
org.geometerplus.zlibrary.ui.android#81433:	   Not a bad reader, but the bookshelf option other readers offer would make this one even better. It needs an actual bookshelf view, not the one currently offered. And the bookshelf needs to be able to auto load from the external sd card like pocketbooks does and keep the books in author then series order. I don't like how I can't see my entire library, I have to view them one folder at a time! Fix this and I would give five stars. 
org.geometerplus.zlibrary.ui.android#81448:	   Dictionary is not working. 
org.geometerplus.zlibrary.ui.android#81458:	   Crashed everytime I opened it. Thumbs  
org.geometerplus.zlibrary.ui.android#81461:	   ... with Android 6.0 there's a problem. After closing the app it keeps my phone awake until I manually swipe it off from the recently used apps. Otherwise my phone stays with screen on forever ignoring my Display setting to turn off the display after 15 seconds. Fix this and I will renew my rating. 
org.geometerplus.zlibrary.ui.android#81462:	   Ive been using this app for over a year and a half, and have had no problems with app. I was pretty happy with it, but recently I've been having some issues with it. To make finding books easier I have placed them into folders for easy finding, however I've been noticing that those books I had placed there keep disappearing which is really annoying. Also, when choosing the series option it does the same thing they disappear. I don't know what happened, but PLEASE fix this problem. 
org.geometerplus.zlibrary.ui.android#81473:	   Sometimes I used it will show crashed and I can't open my book back. 
org.geometerplus.zlibrary.ui.android#81483:	   Free version is impeccable. Having enjoyed every good feature in free version I decided to show my appreciation by purchasing the premium version and I'm so disappointed with it. I'm required to go online every single time I open it to verify my license before I can use it. Which clown's brilliant idea was that? Please fix it asap! 
org.geometerplus.zlibrary.ui.android#81491:	  I tried the Sep 25, 2015 version. 1. Doesn't show images. 2. Doesn't render lists. 3. Can't go back to list of books I have on the device when I hit the Back button. 4. Crashes constantly every day. 
org.geometerplus.zlibrary.ui.android#81500:	  While scrolling, 1st time touch is not working.... need 2nd time touch, annoying issue :( 
org.geometerplus.zlibrary.ui.android#81504:	   Firstly, this app doesn't have some of the books I want. I couldn't find Slaughterhouse-five, Animal Farm, or any Philosophy/Sociology books at all. Secondly, the search bar option is horrendous. If I type anything into the search bar; it loads for hours on end. Even when I want to stop the search I had made, it will keep on searching for the book I searched. It also is not accurate with what it gives. The search word 'Thomas Paine' gives me books by 'Crystal Paine' as well. 
org.geometerplus.zlibrary.ui.android#81507:	   just a minor glitch: can't click-open fb2 files, just epub. oh the irony 
org.geometerplus.zlibrary.ui.android#81524:	  Crash..crash..crash....droid 5.1.1 nexus.,.crashes on opening..... Pls fix it.... 
org.geometerplus.zlibrary.ui.android#81537:	   There is a problem in Arabic word text in epub books and all books text allignment are not in the proper way ,The rtl is from left to right instead of right to lift. please fix this problem. 
org.geometerplus.zlibrary.ui.android#81545:	   But unless I'm missing it, no widget? 
org.geometerplus.zlibrary.ui.android#81550:	   Doesn't work well with PDF books. 
org.geometerplus.zlibrary.ui.android#81552:	   It the best reading app, very friendly with eyes when reading at night. But it cant read some large prc book, or prc book with internal link. Please fix this and i will rate 5 star :) 
org.geometerplus.zlibrary.ui.android#81574:	  Text to speech do not work. Waste of time do not download. Try @voice read aloud 
org.geometerplus.zlibrary.ui.android#81594:	  This is an excellent ebook reader which until recently rightly deserved five stars. Recent updates (starting from about 3 weeks ago) messed up device going to sleep after application exit. This is (obviously) connected to the app's setting controlling whether to force the display to stay on. When this setting is enabled, after exiting from the app the display stays on until the app is forcibly removed from memory (I forcibly stop it via the launcher). My phone uses Android 4.4.2. These problems never occurred until last month. 
org.geometerplus.zlibrary.ui.android#81618:	   I am impressed with everything else except fit to screen issue. I TRIED PDF BOOK TO READ, BUT WITHOUT THIS FIT TO SCREEN, IT IS USELESS. I COULDN'T FIND THE SETTINGS FOR THE SAME. PLS HELP ME IF THERE IS SUCH A SETTINGS. MY DEVICE IS REDMI 2 
org.geometerplus.zlibrary.ui.android#81623:	   When I press the FBreader it will become black screen, this version got bug. Cannot see anything. Last version no problem. 
org.geometerplus.zlibrary.ui.android#81626:	   I have really liked this reader for a while, but the latest update keeps blacking out my screen. If I pull the menus up then I can see the book, but if I change the page then the screen goes black again. Please fix. 
org.geometerplus.zlibrary.ui.android#81627:	   Of no use if it can't open or find books you own. 
org.geometerplus.zlibrary.ui.android#81642:	   Lots of features. "Read Aloud" and the ability to connect to multiple online catalogs are among my favourites. However the smashbooks catalog does not work. 
org.geometerplus.zlibrary.ui.android#81650:	   Brightness adjustment stopped working. Can you fix this issue? 
org.geometerplus.zlibrary.ui.android#81658:	   Everything is good so far, minus one star because change of brightness level with finger not working on my lg g2. 
org.geometerplus.zlibrary.ui.android#81659:	   I wouldn't know how to make it better... And thanks for fixing the brightness issue so fast! 
org.geometerplus.zlibrary.ui.android#81665:	  pretty great, three problems. 1: the cover image of every book shows up twice in my phone's gallery, flooding it with images. wish the app would save them internally and hide them from the gallery. 2: forces its own formatting instead of allowing the book to decide. i have several books that switch between centered and aligned, but fbreader forces only allows one way. 3. there was an error in one of the books i loaded into fbreader, so i deleted it, pulled a fixed version onto my phone, and hit rescan. what's in my book list? the original non-fixed version. i deleted the book again, uninstalled fbreader, used a root-explorer to remove every trace of the app and book, re-installed, put the new book version in. and it STILL showed the old version. what gives? 
org.geometerplus.zlibrary.ui.android#81699:	   I read so many bad reviews but I still got it! Listen to me if you want the truth: don't get it 
org.geometerplus.zlibrary.ui.android#81700:	   Something happened to it. Rescan library does not do a job, it does not add new books to the list... Can you fix it, please? 
org.geometerplus.zlibrary.ui.android#81707:	   Whenever I try to edit the tags I type them and press done but it doesn't save them 
org.geometerplus.zlibrary.ui.android#81722:	   No worth the time. Cant get it to do 1 thing it says it can do... PDF error wrong format along with everything I tried to use it for 
org.geometerplus.zlibrary.ui.android#81724:	   Doesn't work anymore... Black screen. Uninstalling. 
org.geometerplus.zlibrary.ui.android#81741:	   I wish I could support the developers with the paid version, but it's too expensive. :-( My only issue is that sometimes I can't change fonts, I hate serif fonts so it irks me when I can't change to a sans serif... 
org.geometerplus.zlibrary.ui.android#81742:	  Keeps crashing on my phone. Plz do something about it 
org.geometerplus.zlibrary.ui.android#81751:	   It can open huge epub files without problems. Thanks for this app. 
org.geometerplus.zlibrary.ui.android#81752:	   The only problem I've faced is that I cannot jump to a particular page no. 
org.geometerplus.zlibrary.ui.android#81772:	   Works great for me. It opens the page where I left off without any problems at all. Would totally recommend. 
org.geometerplus.zlibrary.ui.android#81779:	    nice and easy to use.... But I can't use the series option. Any help???? 
org.geometerplus.zlibrary.ui.android#81785:	   Completely reliable unlike my last reader. Use it every day without any problems. Great for reading epub files. 
org.geometerplus.zlibrary.ui.android#81798:	   There's nothing this app won't open. Not only is it fast on my crappy device, it also supports so many file types, has a proper file explorer and gives immense control over the reading experience. But I have mixed feelings about it's PDF plugin. 
org.geometerplus.zlibrary.ui.android#81805:	   When you read pdf in night mode, the screen changes to bright white briefly while you switch pages, fix this and your 6 out of 5!!! 
org.geometerplus.zlibrary.ui.android#81806:	   User to rate this 5 stars when it worked... App won't find new books from search on my s5  
org.geometerplus.zlibrary.ui.android#81808:	   I have used this App across all of my Android Devices. I don't often spend money on apps, but I've just paid for premium. I hope it doesn't let me down. I have FBR free backup just in case; I like the no frills reliability. I have issues sharing books with friends with Windows OS, even though they have FBR reader too. Any advice? 
org.geometerplus.zlibrary.ui.android#81809:	   Tried to open a PDF file with password but it says 'Cannot open this book at the moment' 
org.geometerplus.zlibrary.ui.android#81814:	   lately I have a bit of a problem. After I leave the app, the screen of my mobile phone does not go into a sleeping mode after estimated time. I have to kill apps in the background to make it work (the screen goes into a sleeping mode) 
org.geometerplus.zlibrary.ui.android#81821:	  Use to always use this App but after last update on Galaxy Tab 8" I can't access the menu/settings to adjust the Font Size etc. 
org.geometerplus.zlibrary.ui.android#81824:	   I installed a plugin that reads the book aloud itself like an audiobook. And there's an issue: when I turned the plugin off there appeared a margin between the text and the lower edge of the screen where the player should be. The space didn't disappear even when I deleted the plugin. Please fix. 
org.geometerplus.zlibrary.ui.android#81826:	   Great app. Enjoyed using it for years. Hope continues to run. Had issues but those are all cleared up. So I came back to leave a better review. Tried others but always come back to fbreader. Keep up the great work! 
org.geometerplus.zlibrary.ui.android#81852:	   Using it for a few years now. Have had FBreader even on an old (non smart)phone, it never crashed. Now syncing it with tablet, still works perfectly. 
org.geometerplus.zlibrary.ui.android#81860:	  Display brigthness problem 
org.geometerplus.zlibrary.ui.android#81863:	   This is a great app that will read all of your epubs. The only reason that I gave it one less star is because the app has issues displaying footnotes. It will show that the book contains footnotes, but the link hasn't been opening (at least for me). Otherwise, its a great app! 
org.geometerplus.zlibrary.ui.android#81868:	   Why this app doesn't use default display brightness setting and I haven't be able to change it ? ! Brightness increase to 100% !! 
org.geometerplus.zlibrary.ui.android#81889:	   Although I seem to have one irritating bug, which doesn't allow me to adjust the brightness while in the app. Used to be working just fine. Would give 5 stars if it worked as intended 
org.geometerplus.zlibrary.ui.android#81899:	   It is ok. Bug report... the left side of screen swipe to lower or raise light never worked until I did it once accidentally and the screen darkened to black. Stopping the program did not bring it back. Will try a reinstall 
org.geometerplus.zlibrary.ui.android#81901:	   Trying to open an ebook from my download folder on my SD card, the app freezes. Other folders ok. I've used this App happily for many years, but if I can't open books I'll find another reader. 
org.geometerplus.zlibrary.ui.android#81902:	   Have used this app for a long time now and without fail it just continues to get better! Thanks for your great work Dev! 
org.geometerplus.zlibrary.ui.android#81904:	   Why are the thumbnails in the calibre library so small??? I downloaded this specifically for the calibre access and the thumbnails are microscopic! Please fix this or give us the option to make them larger! 
org.geometerplus.zlibrary.ui.android#81906:	  Having problem to install it. I thought something wrong with my connection, but it wasn't. I can install other apps without any problem. Only fbreader i couldnt. Please fix it. 
org.geometerplus.zlibrary.ui.android#81908:	  Unfortunately either does not open big off files or it is too slow for me to wait. It is too heavy, there are lightweight readers without ads if you want to read that open pdf and djvu files 
org.geometerplus.zlibrary.ui.android#81909:	   Well done problem fixed. 
org.geometerplus.zlibrary.ui.android#81916:	  My fb reader is not working properly anymore. It has unusual characters in the book anc it doesnt open the correct content of the book. Please address 
org.geometerplus.zlibrary.ui.android#81925:	  There is NO REFLOW of Text or Font Size change. Therefore useless for me. Even TTS did not work. Provide detailed instructions in Help. 
org.geometerplus.zlibrary.ui.android#81931:	   So far it seems like a good reader. I was really excited when i saw it in the multi window list on samsung tab s but was disappointed when it did not work. 
org.geometerplus.zlibrary.ui.android#81934:	   Login bug gone. Seems t have been android bug not yours. 
org.geometerplus.zlibrary.ui.android#81936:	   Using for more than 3 years, never needed to switch to another app. But there is a small bug - fullscreen mode is broken when fbreader is invoked from lockscreen (system status bar is visible). Though twice doubletapping (to turn on/off nav panel) returns fullscreen back. 
org.geometerplus.zlibrary.ui.android#81942:	   It was my favorite app for books but ever since the update I'm unable to Open my books. Fix I'll gladly raise to five stars. 
org.geometerplus.zlibrary.ui.android#81959:	   I tried to send the bug report but no action taken please fix this. Can't utilise my yotaphone properly. Too bad for an app with such ratings. 
org.geometerplus.zlibrary.ui.android#81969:	   This is the most versatile of all ereader apps. It can handle almost all file types. If there is a bug in an update they fix it and fix it fast. I even have a version of this on my Nook Simple Touch. 
org.geometerplus.zlibrary.ui.android#81976:	  Bookmark problem 
org.geometerplus.zlibrary.ui.android#81991:	   Still has bugs. Doesn't counting the pages and percentage properly. Book is 77% done on page 9. But doean't bothers me still. 
org.geometerplus.zlibrary.ui.android#81993:	   Please add option for zoom in and zoom out with 2 fingers. Does not open pdf files with password 
org.geometerplus.zlibrary.ui.android#82004:	   Lots of good features. Better than nook or kindle app. Would like to see an easy 'dog ear the page' type bookmark, a la nook, though. Since lollipop update, the keep button lights off while reading feature doesn't work, which is sad; I hope that can be fixed in an update. 
org.geometerplus.zlibrary.ui.android#82006:	   On yotaphone, PDF files crash while sending to back screen 
org.geometerplus.zlibrary.ui.android#82023:	   I have over 300 epubs & FBReader hasn't failed to read even one! Keep up the great work, folks!!! 
org.geometerplus.zlibrary.ui.android#82025:	   Simple, clean, functional. No need to sync books so opens straight away even when you can't get a data connection. Love it, well done. 
org.geometerplus.zlibrary.ui.android#82035:	   But since last update search button isn't working anymore on my HTC desire 500. Update: didn't see your reply until now but anyway it started working again. Not sure if i restarted the phone though. Thanks anyway, i'll try next time. 
org.geometerplus.zlibrary.ui.android#82038:	   This is the best eBook reader on any mobile platform and gets better with every update. You'd be pretty hard pressed to find a book in a format that this app couldn't open. The best part is: IT'S FREE! 
org.geometerplus.zlibrary.ui.android#82040:	   Crashed within minutes of first use. Tablet's Screen brightness is overridden by the app. The app increases brightness to maximum for day and night reading. So, this will drain battery life rapidly, and reading at night will ruin my eyes. It looks like a good app otherwise, except for these very fatal flaws. Why doesn't android have a good stable eBook reader that does a good job with PDFs ?? I have tried a half dozen apps, and all at any price, have fatal flaws that render reading PDFs painful, unreliable. 
org.geometerplus.zlibrary.ui.android#82045:	   Can't use it enough! 
org.geometerplus.zlibrary.ui.android#82050:	   Recently, i cant open epub file on onedrive with fbreader. I only can open with rar or calendar. Please check and fix it. My device is nexus 7 
org.geometerplus.zlibrary.ui.android#82053:	   Open source. No text encoding problem. Can install plugins separately. 
org.geometerplus.zlibrary.ui.android#82057:	   I think FB Reader is the best e-book reader out there, but I have problems with its cache. 
org.geometerplus.zlibrary.ui.android#82062:	  crashes every minute 
org.geometerplus.zlibrary.ui.android#82064:	   I have problem with screen turning off no matter what settings applyed... phone is SG s3 neo 
org.geometerplus.zlibrary.ui.android#82072:	   Love the app. Sometimes loose the bottom line of a page since latest android update but not a major issue. 
org.geometerplus.zlibrary.ui.android#82080:	   Won't sync books I add to FB reader directory on my google drive. Please fix. Android 4.04 Lenovo k860 
org.geometerplus.zlibrary.ui.android#82103:	   Crashes when rtf file contains tables like in xl format 
org.geometerplus.zlibrary.ui.android#82108:	   FBReader keeps surprising me with new features (PDF and multi-window support!), listening to user input, and frequently updating with fixes big and small. Minimal permissions needed (like most apps *ought* to have). No intrusive ads. No constant pop-ups asking for 5-star ratings on the Play Store. And--most importantly--it just does what you want it to do, bells and whistles optional. If only all my apps were written by FBReader's authors! 
org.geometerplus.zlibrary.ui.android#82121:	  I do have some problems with the zoom. 
org.geometerplus.zlibrary.ui.android#82135:	   Doesn't open .txt files. 
org.geometerplus.zlibrary.ui.android#82145:	   New review 1/28/15 After updating to the new version I thought I had a problem with pages getting cut off. Turns out I just needed to turn from landscape to portrait. In the time it took me to figure that out, I heard back from the developer asking for a screenshot. I repeat - great service. I also love the synchronization of my books between devices!- Old review - I had an issue with fonts. Emailed dev on Saturday night. Had an answer by 1:30 Sunday morning. Solved my problem. This is my favorite reader but the customer service puts it over the top. 
org.geometerplus.zlibrary.ui.android#82154:	   Great reader never had a problem I usually read in epub or fb2 on my droid maxx 
org.geometerplus.zlibrary.ui.android#82156:	  Latest update is full of bugs pls fix.... 
org.geometerplus.zlibrary.ui.android#82159:	   Excellent book reader, easy to navigate and use. I had a problem with one of its updates, I received help to correct the issue very promptly. Would recommend to anyone! 
org.geometerplus.zlibrary.ui.android#82168:	   In the 3 years I have used this app, I have had few issues, and any issues have been fixed before I had a chance to report them. My phone is constantly low on memory and this has given me few problems using this app. As opposed to other apps which crash regularly. I highly recommend. 
org.geometerplus.zlibrary.ui.android#82174:	   Great app, never had a problem 
org.geometerplus.zlibrary.ui.android#82187:	   I've been using fbreader since symbian and have always found it to be the most accessible and compatible e-reader. For those having difficulty getting it to find newly added books to external SD cards, I've found the best workaround is to use 'Browse file system' --&gt; 'Entire file system' --&gt; 'storage' --&gt; (the name of your external card, e.g. 'sdcard1'). Browse to the folder you added your book(s), and if you open any book in the folder, it will recognize and add all new books in the folder to your library. UPDATE 1/14/15: Application had been freezing a lot in library view/browse with 2.2.2 update. FBreader devs had a quick turnaround with 2.2.2.1 update, which unfortunately did not fix the issue for me. Fortunately, was able to resolve the issue by clearing all app data and uninstalling the app, then manually selecting the library, fonts and cache location in 'settings'. This may be related to how Android 5.0.1 has disabled write access to storageemulated0, so I can't blame the devs for what could be a problem caused by google's persistent tinkering. If you're having issues with Android 5.0.1, it's worth trying this workaround 
org.geometerplus.zlibrary.ui.android#82202:	   Only problem (currently) is that it does not detect new books even with a rescan. Since I didn't see a bug reporting tool on the fbreader website, here is the steps to reproduce: 1) Install FBReader 2) Add books (used calibre) 3) Add second library on expansion SD card 4) Add more books (used calibre) 5) Hit rescan 6) ??? (don't see new books) 
org.geometerplus.zlibrary.ui.android#82206:	   I have never encountered a worse app for reading ebooks. Do not download at any cost 
org.geometerplus.zlibrary.ui.android#82219:	   only this app could open my mobi file, all the other apps failed. 
org.geometerplus.zlibrary.ui.android#82240:	   This is my go to ebook reader! It's light on resources and very reliable. The only issue I have is the pdf plugin not working. It takes forever to open the document and I end up closing out the app, restarting, only for it to not work well again. Other than that, perfect. 
org.geometerplus.zlibrary.ui.android#82243:	   Great app! But why is there a separated lists of the same author/title/series between all-capitalized fonts and not? It seems like an app's bug to me. 
org.geometerplus.zlibrary.ui.android#82247:	   I am quite satisfied with the reader. I frequently use translation options and check how the words are pronounced (since English is not my mother tongue). However, the word pronunciation function does not work anymore ("Error" text is displayed). Could you please fix this issue? Thank you in advance. 
org.geometerplus.zlibrary.ui.android#82256:	  Why can't use translate to field!!!? 
org.geometerplus.zlibrary.ui.android#82274:	   The last update messed it up..I can't search for any books and it won't accept my email address...Hope it's fixed soon because I used to LOVE this app!! 
org.geometerplus.zlibrary.ui.android#82280:	  There are some bugs in the new version! 
org.geometerplus.zlibrary.ui.android#82290:	   Does the job just perfectly. Frequent updates fix issues and add features. 
org.geometerplus.zlibrary.ui.android#82298:	   I have been using FBReader since Android 3. This has been the best eBook reader all through the years. Great functionality, great stability, great performance. Never crashed once or lost where I was in the book. Read so many books on here, now FBReader is the only way I read novels. I recommend this to everyone looking for an eBook reader, other apps just don't compare. Try it yourself. 
org.geometerplus.zlibrary.ui.android#82301:	   Easy to use, very easy on the eyes. No problems whatsoever. Did not use my tablet for reading until I found this. 
org.geometerplus.zlibrary.ui.android#82313:	   Like others have said and I must agree with them, when they say that they have tried others and come back to this one because its the best. Simple as that. And its frequently updated; so you know that any problems with the app will be fixed in a short matter of time. Keep up the good work. I can't praise you guys and girls enough. 
org.geometerplus.zlibrary.ui.android#82315:	   Yep. It's never crashed on me, never failed to play a file I've fed it, and the support for it is incredible. 
org.geometerplus.zlibrary.ui.android#82326:	   Love it, v thoughtful design.  never crash. 
org.geometerplus.zlibrary.ui.android#82333:	   Love this app and previously use it on my tablet. Now download it to my phone.. Never failed to open my ebook, and very easy to use... 
org.geometerplus.zlibrary.ui.android#82334:	   Prevent screen from sleeping is not working 
org.geometerplus.zlibrary.ui.android#82339:	   I am a hard core user and supporter of FBReader. I use synchronisation to keep my books in the library but bookmarks dont get synced. I recently did factory reset and while installing app, I got my books back but wharever bookmarks were there, they are gone. Please fix this issue and bring me back to FBReader. Hence reducing from 5 to 2 stars. 
org.geometerplus.zlibrary.ui.android#82341:	   Easy to use and supports many formats. I am however having problems with the latest update - my bookmarks aren't loading to the correct pages/lines 
org.geometerplus.zlibrary.ui.android#82381:	   I cannot understand why this app is rated so high! The page view is absolutely unreadable. The font settings adjustment Is way too insane. Never seen anything like it. They call it "highly customised". Regular user would not be needing even 5% of the adjustments of the fonts. Tried to set up normal margins or side intent, did not work. By default, the page view is totally unreadable! Try another reader, you'll see what I mean. Uninstalled. 
org.geometerplus.zlibrary.ui.android#82405:	   I was reading books on Kindle Android app but this little open-source app looks better pretty much every way. You can customize virtually everything. Can even add new font_faces of your choice. I still cannot figure out accessing the external micro-sd card though, am limited with the internal storage. Not sure if this is a problem with the FBR as I have this problem with a few other apps already. Overall this is a great reader, makes reading experince more comfortable and enjoyable. Edit: 11/11 update took care of it. External sd card is accessible through device/removable yay yay! 
org.geometerplus.zlibrary.ui.android#82425:	   "Show status bar " in settings does not work after upgrade to KitKat on Xperia. Please fix. 
org.geometerplus.zlibrary.ui.android#82431:	   Keeps track of where you were in the book you were reading and does this for all of your books at the same time. With the plugin it reads your books out loud to you. Works with multiple formats. Simply the best! If you can't get it open PDF files, you can use a converter (I use epubator) to convert the PDF to epub format so FBReader can read it. 
org.geometerplus.zlibrary.ui.android#82456:	   I hate giving negative reviews..its my first. I downloaded this nine times...( one year old app + updates) its nice for short term use...but because of the fbreader failures happens extremely often after a while explicitly now but look else where for professional book reads...major problems saving books now 
org.geometerplus.zlibrary.ui.android#82458:	   It's the best app for android. Wouldn't use any other readers. 
org.geometerplus.zlibrary.ui.android#82475:	   It read mobi files but is draining my battery very quickly. Will delete if not fixed soon. 
org.geometerplus.zlibrary.ui.android#82478:	   I have some ebooks in mobi (*.prc) format. It is the only reader which displayed them in a perfect way as it claimed. Moon reader just can't render them at all !! EDIT : something wrong here. Even after closing it, my battery drains too fast. Synchronisation disabled, TSS auto-load. Have to restart my mob everytime after closing the app to overcome the problem... 
org.geometerplus.zlibrary.ui.android#82489:	   Can't ask for a better reader, does exactly what it says, no ads or pop ups, supports images. Can't get any better... 
org.geometerplus.zlibrary.ui.android#82515:	   Brilliant reader with all the necessary features and no bloat. The online account sync is what really sets it apart for me. I contacted support via email with an issue and they had it fixed within minutes. Well done and thank you. 
org.geometerplus.zlibrary.ui.android#82535:	   It is a very good app and doesn't require many permits as others, but need some improvements, when I touch the screen to make some changes freezes a little in my Philips tablet, I hope you could fix it please. 
org.geometerplus.zlibrary.ui.android#82547:	   Was great but started crashing. Had to uninstall and reinstall and now I seem to have lost some of the catalogs :( I no longer have as many great selections as before... 
org.geometerplus.zlibrary.ui.android#82572:	   Why doesn't half the settings actually work? For example, text settings like to increase text size don't work. Also could do with improved app appearance. 
org.geometerplus.zlibrary.ui.android#82577:	   Crashes. Won't open file folders. No idea how the reading experience might be since it wouldn't open perfectly normal books other readers had no problems with. 
org.geometerplus.zlibrary.ui.android#82596:	   An app then has lots book that i cannot find in other app is a good app, and that's what it matter. 
org.geometerplus.zlibrary.ui.android#82626:	   Does not sync with the Windows Phone app. It's rather ugly compared to other apps. 
org.geometerplus.zlibrary.ui.android#82627:	   Although it's a good app it can't access my external SD card despite it saying that it can. 
org.geometerplus.zlibrary.ui.android#82629:	   5 stars goes to l the background Color that had replaced the withe color. BUT I'M EXPERIENCING PROBLEMS !!! When I try to go to the next page it goes to next page for a sec and then turns back. My device galaxy Note 2 
org.geometerplus.zlibrary.ui.android#82635:	   Amazing! But it does not deserve 5 stars because I can't find a lot of the books that I like, but I guess that just counts with what your opinion is so I can't really say anything bad about it, but then again they should think about other opinions but other than that it is ALMOST perfect!!! 
org.geometerplus.zlibrary.ui.android#82647:	   Very efficient reader. Never fails. 
org.geometerplus.zlibrary.ui.android#82687:	   The app is really great and useful. I haven't experienced any bugs or glitches. The only think that bothers me is that it doesn't have home screen shortcuts for the books in the library but overall it's an awesome app. 
org.geometerplus.zlibrary.ui.android#82691:	   downloaded the pdf plugin, but crashes a lot when reading scanned pdf files. For reading pdf files Moonreader is better. Overall Moonreader is my first choice. 
org.geometerplus.zlibrary.ui.android#82694:	  Good job fixing the weirdness with Newsstand, still my fav epub reader 
org.geometerplus.zlibrary.ui.android#82695:	  Very fast fix for the random start while in newsstand! Thanks for a great reader. 
org.geometerplus.zlibrary.ui.android#82696:	   Although program prompted a message that I can download PDF plugin to open a document it doesn't work. If only PDF plugin was available it would be perfect. Must-have app. 
org.geometerplus.zlibrary.ui.android#82733:	   First and foremost its a great app, with a wealth of features and nice interface. Second if there are any bugs I'm yet to encounter them! Third not only is it free its Add free! Hats off and thanks to the developer/s ... PS Developers - If your looking for a way to make it even better might I suggest allowing zooming diagrams to full screen. 
org.geometerplus.zlibrary.ui.android#82734:	   Developers, sync is not working on kitkat (intel) plz try to fix it. Anyway 5star for my love to ur app 
org.geometerplus.zlibrary.ui.android#82754:	   pdf plugin link provided doesn't work, please resolve. thank you. 
org.geometerplus.zlibrary.ui.android#82759:	   Using it for my E books since then, never had problems with it. 
org.geometerplus.zlibrary.ui.android#82762:	   This was the first EPUB reader I found, and the first I ever used, and I can confidently say that it's one of the best. I'm not even going to bother trying the other apps because this one meets all my needs and I am very satisfied with it. It's simple and efficient. The only issue I have with this (and it's a big issue, too) is that whenever I use this app to download my EPUB files, it almost always crashes and I have to force stop the app. I usually have to try it another 2-3 times for the file to download 
org.geometerplus.zlibrary.ui.android#82774:	  Does the job, love it. Recent upgrades fixed the slow loading and the sd card directory problems 
org.geometerplus.zlibrary.ui.android#82780:	   Could you pls implement showing  when popup menu is shown, even if in settings  is set to be hidden? Otherwise there is no access to the library. Thanks. 
org.geometerplus.zlibrary.ui.android#82796:	   Can't find mobi file to import so I can read book. 
org.geometerplus.zlibrary.ui.android#82810:	   I installed a whole bunch of readers, and this one stands above the rest. It supports both epub and azw3 out of the box. It's open source. The beta supports PDF via a plugin. I installed the beta from their website, as well as the PDF plugin and haven't had any issues. 
org.geometerplus.zlibrary.ui.android#82827:	   It is always crashing and I should always uninstall then reinstall it by going on playstore.it would b better if t stop crashing and I wouldn't have to always go to add back z books zat I lost. I like z fact zat it has a dictionary and I can download books from fbreader itself but t should expand its range.Hence, t could have been better!Hope this review would help make t better! 
org.geometerplus.zlibrary.ui.android#82831:	   When I first saw this app ( when my mother was reading her book ), it had seemed to work fine. Today, I had downloaded it to read some fan fiction ( don't judge) but, when I had tried to open the text document, it said permission denied. I had went into the settings and allowed it to search for books in the downloads section, but then it started crashing. If this is fixed, it will surely be worth five stars. The files were DRM-free .txt documents. 
org.geometerplus.zlibrary.ui.android#82852:	   after updating to kitkat, cant open fbreader. "fbreader cache directory is not accessible".. fix pls.. 
org.geometerplus.zlibrary.ui.android#82854:	   My problem solved after I ve reported, but it cost me a fw update of my tablet. Still local directory duplicate books are listed as separate items, but anyway makes book reading fun, thank you. 
org.geometerplus.zlibrary.ui.android#82860:	   My android device just updated, and now words are bleeding together. This happens often enough I know it is not just the books, and it makes it difficult to read. Until this is fixed, I'm going to have to give it only 3 out of 5. 
org.geometerplus.zlibrary.ui.android#82875:	  Liked it before the update. Now I can't remove the blue strip and the message that goes with it from the screen to be able to read. 
org.geometerplus.zlibrary.ui.android#82915:	   Great reader, but it can never store the current position - every time I reopen the app, it either resets the position to the beginning or takes me a few chapters back. Also, sometimes it forgets the page turning settings - needs to be force closed and reopened to fix. All of these make reading really annoying, I did not have these issues before. 
org.geometerplus.zlibrary.ui.android#82919:	   had problems after upgrade with tts plugin crashing. after removing and reinstalling reader, its back to 5 star rating ,T-Mobile G2x 
org.geometerplus.zlibrary.ui.android#82922:	   With my need to always have a book close at hand this app provides me with the best option as the book format is rarely a problem 
org.geometerplus.zlibrary.ui.android#82931:	   Used to be great - now a big blank screen, won't load any books. Have reported problem. 
org.geometerplus.zlibrary.ui.android#82932:	   Great app.. Shows page number, time, battery level on screen.. Love it. Works on my nexus s and nexus 7 without issues. Would love a sync feature! **update, since last update this app froze when browsing for my next book.. Then was broken. Rebooted phone, still broken. Reinstalled and it appears to work, however I can't get the initial "center third of the window for settings" overlay to go away. I essentially cannot use this app now. Back to aldiko 
org.geometerplus.zlibrary.ui.android#82961:	   While I absolutely love your app, these last few updates keeps force closing some of the previous ebooks that I had read and was rereading.. Please fix it.. I really love this app. 
org.geometerplus.zlibrary.ui.android#82972:	   I expect a certain level of formatting when I open and ebook. While this app is stellar in every single aspect, it lacks the ability to show an ebook in the default formatting with the full CSS codes implemented. So rather than titles being large and properly centered, headers being flush left, and only the body text indented, everything is indented and the same font size. Very annoying after you spend hours to fix the formatting of an ebook. So on one hand this is the best ereader out there for android (ease of use, speed, text-to-speech, and many other features), it has the worst formatting so I have to rate it 2 stars. 
org.geometerplus.zlibrary.ui.android#83010:	   Hmm ... Downloaded this application, went to read some books. The author must have forgotten how to read a book or introduced a horrible bug. There is a horrendous background graphics that cannot be fixed/removed that make reading books extremely hard, and stressing on the eyes. DO NO T BUY!! Another big issue. This calls home, which prevents you from running this on a private network. Read: SCAM 
org.geometerplus.zlibrary.ui.android#83012:	  Error -24 while installing! 
org.geometerplus.zlibrary.ui.android#83026:	  The app used to work great until last update Now every time you hit the read it crashes. I uninstalled and reinstalled and still the same so the new app is not good. Useless I used to love this app. Can you please fix it. 
org.geometerplus.zlibrary.ui.android#83027:	   It ain't read from right to left, please fix it 
org.geometerplus.zlibrary.ui.android#83031:	   Problem opening and searching for books. Doesn't open and can't read it. Use to work long time ago. 
org.geometerplus.zlibrary.ui.android#83048:	   Works without problems. Very nice 
org.geometerplus.zlibrary.ui.android#83054:	   spoiled page scrolling! Please, fix. That the only thing I need from this application: fast scroll. 
org.geometerplus.zlibrary.ui.android#83060:	   I love how this program converts other format into an easy and reading friendly formats. Font size can be change without effecting the reading format, words can easily defined, and book marks can be easily added. Much better than reading an unmodifiable PDF. Have crash on me at all. Thanks! 
org.geometerplus.zlibrary.ui.android#83062:	   can't go to menu and to settings on ICS on Galaxy Nexus. please fix this problem. 
org.geometerplus.zlibrary.ui.android#83069:	   Since Cool Readers current failure to open MOBI files, this has become my goto. TTS works great here with the plugin, too. 
org.geometerplus.zlibrary.ui.android#83071:	  This Is great and I still give it five stars but a little heads up the book Beautiful Disaster by Jamie McGuire keeps making it crash and I have to uninstall then install it again 
org.geometerplus.zlibrary.ui.android#83075:	   I was looking for an app to read my ebooks to me as I was in bed with flu and my eyes hurt from reading this app did it perfectly and i quickly got used to the monotone voice and find myself adding expression to the female voice it really is a very good app I have found a small bug if a new paragraph starts on a new page sometimes the first letter of the first word is missing in portrait mode 
org.geometerplus.zlibrary.ui.android#83083:	   This is a GREAT reader especially with the TTS pluggin it shines out from the rest. However the problem i am having is that when using the the TTS pluggin, the screen goes off automatically. This obviously defeats the purpose of highlighting the text when reading aloud. Am i missing something here? Need guidance by other users or the developer. Cheerio 
org.geometerplus.zlibrary.ui.android#83093:	   -- this does everything a reader should do and is easy to use. The built-in web search for books works well. My only criticism so far is that when you search for folders on your own device, it doesn't see the external SD card. However, if you change the default books folder to one on the SD card by typing the path by hand, it uses this without problems. 
org.geometerplus.zlibrary.ui.android#83097:	  Very good application - clean and simple with all necessary features, plus a few extras such as the (Now working) TTS+ plugin. One of the few, if not only, programs I have used on Android that doesn't constantly crash. 
org.geometerplus.zlibrary.ui.android#83116:	   I've used FBReader for years and love it. But recently it often loses my last reading position on my Galaxy S4 GPe with stock rooted Android KitKat 4.4.2. A fix would be very much appreciated! 
org.geometerplus.zlibrary.ui.android#83143:	   Please fix it 
org.geometerplus.zlibrary.ui.android#83152:	   Everything about this app is awesome. The only problem is how do you change the auto brightness? It keeps dimming on me even though my setting has 2 min till screen dull and auto brightness off. 
org.geometerplus.zlibrary.ui.android#83156:	   Couldn't create bookmarks anymore, contacted developer and he fixed it presto! Tried all readers and this is simply the best. 
org.geometerplus.zlibrary.ui.android#83160:	   Great android e-reader. Lightweight, fast and supports a variety of formats. In app brightness override feature is awesome. Just need to fix the terrible highlighting feature! 
org.geometerplus.zlibrary.ui.android#83166:	   Installed Fbreader (ver 1.9.6.1) in ma nexus 5 Post which i downloaded couple of epubs from my gmail and the same got placed in the downlads folder of my nexus5 mobile. initally FBreader allowed me to add those epubs to the library and i started using it. was entharalled by the reading experience in FBreader, however it didn't last long. When i connected my nexus5 to cpu for charging some thing went wrong with the FBreader syncing and now my attempts to re-add the epubs to FBreader has failed gravely. Will appreciate if any of u help me to sort this. 
org.geometerplus.zlibrary.ui.android#83172:	   I love it. Havent run into any problems so far. Recommended it to a few friends. 
org.geometerplus.zlibrary.ui.android#83180:	   Every other ebook reader I've tried has had minor problems which rendered them difficult to use. But this is more or less perfect. And it's free! 
org.geometerplus.zlibrary.ui.android#83233:	   Never failed me while using, easy to use, great layout. Simple yet functional. Not needed another reader app since download....keep up the good work! 
org.geometerplus.zlibrary.ui.android#83238:	   This is a great epub reader with a wonderful interface and controls. The only issue is that it implements its own brightness controls and doesn't respect the global Android brightness setting (at least on my Galaxy Tab 2) 
org.geometerplus.zlibrary.ui.android#83240:	   Great app for reading, it had some issues but I think is because of my phone XD 
org.geometerplus.zlibrary.ui.android#83243:	   The light adjustment is great -not too bright, not too dark. Ad free. Doesnt lag. Really friendly. The only problem i have is selecting the text because its not that accurate and It kinda takes time. I really do hope that the text selecting will be fixed because i have to press one line below the word and it's been bothering me. 5 stars if this is fixed for the next update. 
org.geometerplus.zlibrary.ui.android#83285:	   I cancel the bad review I have earlier as it was on error. This seems like a good app. The only problem I are is difficulty summoning the standard Android navigation buttons. 
org.geometerplus.zlibrary.ui.android#83288:	   Love this reader. Tons of customazition, decent display and support of Mobi-book format. The only thing negative I see sofar is the slow opening, especially by ePubs; sometimes it took 10-20 secs just to open a book. If you can fix this, it would be perfect! The default display of the library is also confusing and not helpful. Better chage the default view to show all books in bigger cover thumbnail. If you have under 100 books on your device, I think browsing all is the best way to navigate. 
org.geometerplus.zlibrary.ui.android#83291:	  Crashes straight away on nexus 7 
org.geometerplus.zlibrary.ui.android#83292:	   Tried moon reader pro and other apps.. this one beats everyone.. please work towards PDF files.. also as I am medical student big bulky files won't open quickly... Please fix.. otherwise 5 stars 
org.geometerplus.zlibrary.ui.android#83298:	   I have never had any problems,and i use this app almost daily. 
org.geometerplus.zlibrary.ui.android#83306:	   Only problem is when I have tap to turn enabled -- it sometimes turns the page when I accidentally palm press. 
org.geometerplus.zlibrary.ui.android#83321:	   Great app! Few major problems if any! 
org.geometerplus.zlibrary.ui.android#83334:	  Never had a problem. Very good application. 
org.geometerplus.zlibrary.ui.android#83344:	  Perfect, customizable, bug free 
org.geometerplus.zlibrary.ui.android#83353:	   Its a good app but it doesn't recognize a pdf file talk more of reading it out. Pls help solve the problem and I promise a 5STAR!! 
org.geometerplus.zlibrary.ui.android#83360:	   I can no longer set the margins...I tried all the settings. Now I have a page wall of words. Back to Moon Reader which also reads mobi and epub. Montana and Aldiko also look better than this. I used to love it but no more. It wasn't broke but it is now. PLEASE FIX! 
org.geometerplus.zlibrary.ui.android#83375:	   Won't even page, freezes my Galaxy S4. Wasn't like this in the past, but now I can't use it. 
org.geometerplus.zlibrary.ui.android#83387:	   I can't figure out why people can't find this. They rave about apps half as functional, iterate a bug, and praise some more. FBReader is and always has been entirely bug free for me, and does everything I need it to do.. Dropbox sync is a godsend, and it's all free. Wish I could tweet this at the library! 
org.geometerplus.zlibrary.ui.android#83388:	   Previously I was using moon+ reader, but it's free version does not support TTS. I do have a couple of problems with this reader. First, the touch location is wrong. To select a word, l must press one line below the intended word. Second, the interface is somewhat confusing. It's not obvious how to move between the various screens. For example, after downloading a book it's not easy or simple to start reading it. 
org.geometerplus.zlibrary.ui.android#83392:	   Never written an app review before, but had to for this one; it's flawless, free, no ads or nag popups, works blazingly fast even on my old phone (and even if the book has illustrations). It remembers where you were in a book after you close it (seems like a no-brainer feature, but some reader apps actually do fail in this regard). Dizzyingly customizable. Turn on night mode and tell it to disable the notification bar and menu button LEDs, and you get a true distraction-free "curl up in bed with a good book" experience. I've done almost nothing with my phone except read ebooks since I downloaded this. A+ 
org.geometerplus.zlibrary.ui.android#83407:	   ... for what it does. Can't find any real flaws, except only for the rather dull looking page turning animations. But that's nitpicking really. 
org.geometerplus.zlibrary.ui.android#83415:	  Too many crashes 
org.geometerplus.zlibrary.ui.android#83438:	  It can't open mobi files 
org.geometerplus.zlibrary.ui.android#83446:	   I don't buy a book if I can't get it into FBReader 
org.geometerplus.zlibrary.ui.android#83482:	   Never failed me great features easy to use 
org.geometerplus.zlibrary.ui.android#83492:	   I tried like 15 readers, and this one has a nice display, it is pretty fast, and I haven't encountered any problems with it yet. The only thing that can be improved is the document choosing interface. Maybe make a books icon menu instead of just the file tree? 
org.geometerplus.zlibrary.ui.android#83500:	   I tried lots of other and still came back. This app is amazing and fast! It runs cleans and never crashes :) 
org.geometerplus.zlibrary.ui.android#83539:	   It's so intuitive and easy to use. It supports almost all formats and the updates quickly fix any issues (hardly any) that arise. 
org.geometerplus.zlibrary.ui.android#83565:	   I downloaded a book and it showed that its in my library but its not opening ..dunno it was going so well but im installing it open ..hope its a one time fault ... Otherwise the app is amazing . 
org.geometerplus.zlibrary.ui.android#83569:	   I use it everyday to read the classics. Fast. User friendly. Battery efficient. It just works without a single problem. Thanks! 
org.geometerplus.zlibrary.ui.android#83578:	   I had fun with this app for a while. The offline dictionary was definitely the best part. There were still some formatting errors handling some files. Thank you 
org.geometerplus.zlibrary.ui.android#83589:	  Won't open, keeps crashing! Please fix, I love this app! 
org.geometerplus.zlibrary.ui.android#83606:	   Reads my books out to me! Adt I found one. Love books but have issues seeing so Thank you :) 
org.geometerplus.zlibrary.ui.android#83620:	   Nice reader, but there is no sync option. I have to download books that I already have downloaded in another device. 
org.geometerplus.zlibrary.ui.android#83634:	   The latest update crashes when i return to the library. And I don't want the my ePub reader running background services. 
org.geometerplus.zlibrary.ui.android#83640:	   Everything that I need. Never have a problem. It always gets better. Small, tight, feature rich program. 
org.geometerplus.zlibrary.ui.android#83653:	   This e-reader is the best out of all the others I've tried, and I've tried MANY. However one thing that really keeps me from being 100% satisfied with it is how there is no bookshelf where you can see the covers of all your books. I REALLY love this feature and it is the only problem I have from what is otherwise a really great app. The best, in my opinion. 
org.geometerplus.zlibrary.ui.android#83658:	   I REALLY like this app, but loading and navigating large documents (like a Bible) just takes too long. This would be the only reader I would ever use on all my Android devices if this issue were resolved. 
org.geometerplus.zlibrary.ui.android#83665:	   Fast, opens mobi wihout issues contrary to Moon Reader. 2 wishes: dropbox or drive based reading position sync, increasing screen timeout while reading. 
org.geometerplus.zlibrary.ui.android#83690:	   This e reader app just works - no fuss , no problems. Very nice interface and easy to navigate options setting. I really like the slide finger up and down the side of the screen to adjust the screen brightness and the optional curling effect as the pages are turned. seems to just open any .epub files no matter where they were downloaded from. Works on files that Kindle and Google books failed to open. Highly recommended - and it's free. Installed on Samsung Galaxy S4. 
org.geometerplus.zlibrary.ui.android#83714:	   Better than it was the last time I downloaded it. Just fix the TTS plugin to support Google TTS and you'll get 5 stars. 
org.geometerplus.zlibrary.ui.android#83718:	   You guys did a really awesome job... This is a decent app to read any ebook... But one problem is it wasn't integrated with arcus dictionary and arcus pro... because that's the only dictionary that was great with every words, either medical or other words Can you please add support to arcus dictionary to become the best reader there is on android? Thanks team... but anyways, you already got a 5 stars for me 
org.geometerplus.zlibrary.ui.android#83730:	   So, this is a GREAT e reader, better than iBooks I used on my old Apple tablet. So I dunno what all I heard about no e-reader options for Android before I switched was about. This app has great display options including a night mode and brightness adjusting via swiping the right edge of the screen, it can prevent your tablet screen from shutting off (or you can choose to prevent it until a certain % of battery life remains and then move into battery life mode) . It can handle ALMOST all of the formats I want, great on the eyes, great bookmarking for coming back to a specific place, and it automatically saves your place in the book when you close the app or switch to read a different book. Hyperlinks in your book table of contents or in the text giving a link to an Appendix are easily followed and you can move right back to where you were in the book. You can organize your library on the disk and access books via the file tree for easy organizing. This is the best e-reader I have found. 1 problem - it can't read PDF files. It doesn't even see them on the file tree when looking at your library. You have to convert the files. ADD PDF SUPPORT PLEASE!! 
org.geometerplus.zlibrary.ui.android#83732:	   Can't open compressed books, using coolreader instead 
org.geometerplus.zlibrary.ui.android#83736:	   It reads arabic in reverse order, for example : it reads the sentence "never throw anything from the window", like this: "Window the from anything throw never". Funny. More stars if fixed. 
org.geometerplus.zlibrary.ui.android#83739:	   This app has problems showing struck letters. 
org.geometerplus.zlibrary.ui.android#83742:	  My epub file wad loaded at first time later after many tries, it fails to open it. Please fix it asap. Thanks for providing helpful UI. 
org.geometerplus.zlibrary.ui.android#83748:	   I was having problems finding the right reader for ePub formats and unknown formats. They either couldn't center the page or the zoom, but this one is really nice. Thank you so much creators. Anybody else with problems, download this app it works. 
org.geometerplus.zlibrary.ui.android#83752:	   Never had an issue (using it for 1.5 years already). Very convenient and ergonomic. Fast library and search. Works flawlessly with Calibre. 
org.geometerplus.zlibrary.ui.android#83758:	   Samson galaxy tab2. Completely fails to load a book. 
org.geometerplus.zlibrary.ui.android#83760:	   Crashes every time i use it Galaxy s2 
org.geometerplus.zlibrary.ui.android#83762:	   I love to read and have tried all the ebook readers. This one stands out. Miles ahead. The parchment background (instead of glaring white) is easy on the eyes. The bottom info line shows total pages, time, etc. Two columns or one column in both landscape and portrait. Easy to import ePub books. Try it. You'll love it! No, I do not work for them. 
org.geometerplus.zlibrary.ui.android#83763:	   This app has served me for over a year now on multiple devices and has easily been the simplistic, feature packed, smooth reading app I have ever encountered. With night viewing, adjustable brightness in-app, file support, themes and library support, how can you not use this app over many others??? 
org.geometerplus.zlibrary.ui.android#83780:	  I really love it. The only problem? It doesn't have a bookshelf view to explore the books in a better way. 
org.geometerplus.zlibrary.ui.android#83801:	   Extremely poor handling of .mobi format results in constant error toasters indicating "API Errors", long pauses, and very sluggish performance. With some help from the TTS plugin development team, was able to find a workaround -- .epub seems to be handled somewhat better -- performance is better, and I see the errors less frequently. Very frustrating. The format really shouldn't be supported at all if it's done this sloppily, and the error messages are so poor that it took me forever -- and the help of a plugin developer not associated with this app -- to find a workaround. 
org.geometerplus.zlibrary.ui.android#83831:	   The simplicity and usability of this app is what makes it. And no it does not need a shelf view. Gimmick. Might look nice but not functional. List view enables seeing more books at once. I prefer it. Some readers have lots of features but don't get the basics right. For example Moon Reader Pro. Lots of features but laggy with large books with lots of hyperlinks. So bad, I removed even though I paid for it. FB kills it for basic performance. The features it has are very usable. Clean interface. 
org.geometerplus.zlibrary.ui.android#83872:	   I used this program to read prc book and thought it was fine, until I read the same with Cool Reader and Zo Reader then noticed there are many texts not displayed with FBReader! It just displayed the beginning of the section them jumped to the last paragraph! Update v1.8.1: same error with FBReader, strange! And some formatting are lost too. 
org.geometerplus.zlibrary.ui.android#83874:	   I have been using this app for years. But just got Galaxy S4. I am having problem with epubs recognizing from the download. I can open from within the app. Just can't click on the download and it bring up fbreader. 
org.geometerplus.zlibrary.ui.android#83879:	   Cannot open a file that is not in /Books folder. Using AlReader now. 
org.geometerplus.zlibrary.ui.android#83891:	   It was a great app at first but every time I open it now it immediatly crashes. I have an android KROSS so maybe its just my device but I really want to use it again so please fix 
org.geometerplus.zlibrary.ui.android#83894:	  Brightness adjustment does not work, nor shutoff bottom buttons. HTC 3d. 
org.geometerplus.zlibrary.ui.android#83900:	   The second day i was using this app, it crushed. One moment the app was running usually the other my phone went into safe mode, calibration changed, touch screen didin't work. Couldn't use the phone for DAYS. Could have given 5 stars if this hadn't happen, too bad. The app itself is well but it had KILLED MY PHONE. 
org.geometerplus.zlibrary.ui.android#83907:	   This worked great until tonight. All of a sudden it just scrolls thru book really fast with no sound even though cells vulomn is up. Please fix....was best ap! 
org.geometerplus.zlibrary.ui.android#83927:	   colordict dictionary can't find more than half of the words that i look up. I would love to see a simple google dictionary search. e.g. "define: scabrous" otherwise great app, keep it up 
org.geometerplus.zlibrary.ui.android#83964:	   I've tried at least a dozen different ereader apps and this is the one we always fall back on. Connects to my Calibre OPDS server without any issues. My only complaint, is that you can't delete the preloaded internet servers and this confuses my wife. 
org.geometerplus.zlibrary.ui.android#83987:	   Thanks for such great app! Is any chance to fix the option of dimming the light of the soft buttons? After an upgrade to Android 4, this option is no longer works on HTC Desire S. 
org.geometerplus.zlibrary.ui.android#83999:	   Problem with selectig a word. It selects... on the upper row!! It is quite hart to work with the marks for selecting! Please fix! 
org.geometerplus.zlibrary.ui.android#84003:	   Alright it works fine but I am totally sick of having to reinstall everytime if I turn my tablet off it won't work....and then my tablet shuts down again now can't read my fave books 
org.geometerplus.zlibrary.ui.android#84013:	   I read a few books with it now and does strange things like suddenly change the font in a new chapter to bold. Or in one book it doesn't recognise that every second chapter is in italics. I'm blaming FB for this as these books all work fine in Aldiko. My other gripe is that I went to a lot of trouble to contact the developer several times and included samples of the problems but have never got a reply. 
org.geometerplus.zlibrary.ui.android#84014:	   Best ever, buuuut I don't know if it was an update or something I did, but for some reason chapters don't start on a fresh page anymore. They just continuously flow, not a problem at all, just o.c.d issue for me 
org.geometerplus.zlibrary.ui.android#84020:	   Works well, easy to use, and open source (which is a huge plus). Main downsides are: limited support for tables and CSS, limited EPUB3 support. This means that many books have small display glitches. EPUB3 is increasingly important (at least for me), and I now find myself using the free (but sadly not open source) gitden reader. 
org.geometerplus.zlibrary.ui.android#84021:	   Have used this app for so long and havnt been dissatisfied once. I have finished 8 books without a single problem. 
org.geometerplus.zlibrary.ui.android#84036:	   Would give five stars but crashes frequently and looses place in book. PLEASE FIX!!!! 
org.geometerplus.zlibrary.ui.android#84041:	   Good app, but doesn't work after last update. I'm using Galaxy tab 10 
org.geometerplus.zlibrary.ui.android#84048:	   I used this app every day. Then when I update it, it won't open! Just force closes. How do I read now? Plz fix. 
org.geometerplus.zlibrary.ui.android#84051:	  Update problems 
org.geometerplus.zlibrary.ui.android#84059:	   Simplicity and perfection. A pleasure to use. Searching, scanning, and library features work well. The only minor issue is that it doesn't identify books by checksum, so renaming a book makes you lose your position. 
org.geometerplus.zlibrary.ui.android#84069:	  This is it. I've tried many readers but each one had some kind of issue. But this reader is flawless while remaining light weight 
org.geometerplus.zlibrary.ui.android#84074:	   Best fb2 reader on the market. Highly customizable, but very clean in design. Never had any problems with it. 
org.geometerplus.zlibrary.ui.android#84075:	   1.7.7 fixed my blank screen problem. I found Geometer Plus' support to be excellent. FBReader is the best e-reader I've found. 
org.geometerplus.zlibrary.ui.android#84080:	   Works without fail! 
org.geometerplus.zlibrary.ui.android#84081:	   As the title says. I store my ebooks on my microsd card, which this can't access for some weird reason 
org.geometerplus.zlibrary.ui.android#84083:	   Never been able to use our update this app, kept coming up with a server error good bye 
org.geometerplus.zlibrary.ui.android#84089:	   The best reader for Android hands down. Never had a single issue even though there are regular updates. Keep in mind I have only tried free readers. 
org.geometerplus.zlibrary.ui.android#84095:	  Great app until you update . Now all it gives is a blank screen , locks up and crashes the phone . Have to move to another reader. Very dissappointing 
org.geometerplus.zlibrary.ui.android#84100:	  Dis app was great but the last update ruined everything. Plz fix 
org.geometerplus.zlibrary.ui.android#84107:	  Awesome app, never fails to please. Tried a bunch but always return to this one. 
org.geometerplus.zlibrary.ui.android#84115:	   The soft key button lights won't dim in night mode on the HTC One X. Apart from that, a fantastic app. But this is one really annoying issue, hence rating reduction until fixed. 
org.geometerplus.zlibrary.ui.android#84142:	   The app is crashing when i try to scroll to previous page. Pleas rectify it ASAP. I will improve my rating. 
org.geometerplus.zlibrary.ui.android#84147:	   It used to be my favorite reader, it still is, haven't uninstalled it, I'm just waiting for the bugs to be fixed hopefully soon. As other reviewers pointed it, the latest versions are slower, take more time to open books, crash more often. Many times don't even detect books in library even when other readers are able to read from the same books folder on SD card. I have been using cool reader as a temporary replacement and praying that FBreader gets well soon and becomes the same amazing app it once it was. 
org.geometerplus.zlibrary.ui.android#84151:	   It does what I need it to do and does it well. I've never had an issue with it. The app is regularly updated to fix any issues that other users have experienced. 
org.geometerplus.zlibrary.ui.android#84164:	   Was my favourite ereader until update. Now won't work at all grrr. Fix this please 
org.geometerplus.zlibrary.ui.android#84167:	   Installed on HTC G2. Consistently tells me fb cache directory not accessible for writing. Uninstalled. 
org.geometerplus.zlibrary.ui.android#84187:	  The last update really ruined this previously wonderful program. Hope they fix their fix. 
org.geometerplus.zlibrary.ui.android#84195:	   one small problem: needs to be able to backup and restore settings. 
org.geometerplus.zlibrary.ui.android#84197:	   Excellent reader - love the customizing and the speed. Only problem seems to stem from really large MOBI files - they don't register as e-books to be read. 
org.geometerplus.zlibrary.ui.android#84203:	   No problems all through 2012, but in jan and feb 2013 it has crashed almost daily. I send an automated report and hope for the bug to be remedied. 
org.geometerplus.zlibrary.ui.android#84217:	   After latest update, click on my sms alert on upper notification bar screen will launch fbreader! Pls correct this error asap 
org.geometerplus.zlibrary.ui.android#84252:	   I don't need too much; the ability to reliably load .epub files (Moon Reader failed on some!), and swipe to turn pages (none of Moon Reader, Aldiko or Cool Reader could do that, at least, not that I could find easily in their settings pages). So, surprisingly, much better than all the other popular ones... 
org.geometerplus.zlibrary.ui.android#84272:	   I keep running into this weird bug on my tablet: on some pages the reader turns off my screen and renders my tablet useless. 
org.geometerplus.zlibrary.ui.android#84282:	   I am using this app for a long time and I didn't find anything to complain of. Keep with good work, guys! 
org.geometerplus.zlibrary.ui.android#84303:	   Setting this to read books from the external card results in an error, unable to write to the cache directory, which should be stored on internal memory. However, when leaving the setting on the default, it cannot access the books on my card. 
org.geometerplus.zlibrary.ui.android#84313:	   Its an amszing app runs smooth, but there is a prolem with the bookmark feature, sometimes it skip some oaragraphs when i load it, hole you guys fix this soon and other than thay its all perfect 
org.geometerplus.zlibrary.ui.android#84316:	   Long tab on a word gets another word highlighted. Not useable. use trick to get around 
org.geometerplus.zlibrary.ui.android#84328:	   Best reading app I have used. The only downside is the lack of a built in sync function. FBSync for root takes care of the issue though an automatic built in option would be nice. 
